{"tileset" : "road.png",
  "map" : [
    [2, 2, 2, 2, 2, 2, 9, 10, 11,  2,  2,  2,  2,  2,  2],
    [2, 2, 2, 2, 2, 2, 9, 10, 11,  2,  2,  2,  2,  2,  2],
    [2, 2, 2, 2, 2, 2, 9, 3 , 11,  2,  2,  2,  2,  2,  2],
    [2, 2, 2, 2, 2, 2, 9, 10, 11,  2,  2,  2,  2,  2,  2],
    [2, 2, 2, 2, 2, 2, 9, 10, 11,  2,  2,  2,  2,  2,  2],
    [2, 2, 2, 2, 2, 2, 9, 4 , 11,  2,  2,  2,  2,  2,  2],
    [2, 2, 2, 2, 2, 2, 9, 10,  8,  6,  6,  6,  6,  6,  6],
    [2, 2, 2, 2, 2, 2, 9, 10,  3, 10, 10, 10,  8, 10, 10],
    [2, 2, 2, 2, 2, 2, 9, 10, 12, 14 ,14, 14, 14, 14, 14],
    [2, 2, 2, 2, 2, 2, 9, 10, 11,  2,  2,  2,  2,  2,  2],
    [2, 2, 2, 2, 2, 2, 9, 10, 11,  2,  2,  2,  2,  2,  2],
    [2, 2, 2, 2, 2, 2, 9, 3 , 11,  2,  2,  2,  2,  2,  2],
    [2, 2, 2, 2, 2, 2, 9, 10, 11,  2,  2,  2,  2,  2,  2],
    [2, 2, 2, 2, 2, 2, 9, 10, 11,  2,  2,  2,  2,  2,  2],
    [2, 2, 2, 2, 2, 2, 9, 10, 11,  2,  2,  2,  2,  2,  2]
  ]}